self.stocks = {
"6A": "AUSTRALIAN",
"ACD": "AUSTRALIAN $/CANADIAN $",
"@YA": "AUSTRALIAN $/JAPANESE YEN",
"AJY": "AUSTRALIAN $/JAPANESE YEN",
"ANE": "AUSTRALIAN $/NEW ZEALAND $",
"@AR": "AUSTRALIAN $/NZ $",
"@KAU": "AUSTRALIAN $/US $ (NEW)",
BRAZILIAN REAL	6L	CME
BRITISH PD/JAPANESE YEN	@PY	ICE
BRITISH POUND	6B	CME
BRITISH POUND/JAPANESE YEN	PJY	CME
BRITISH POUND/SWISS FRANC	@BF	ICE
BRITISH POUND/SWISS FRANC	PSF	CME
CANADIAN $	6C	CME
CHINESE RENMINBI/$	RMB	CME
CZECH KORUNA/EURO	ECK	CME
E-MICRO AUD/USD	M6A	CME
E-MICRO CAD/USD	MCD	CME
E-MICRO CHF/USD	MSF	CME
E-MICRO EUR/USD	M6E	CME
E-MICRO GBP/USD	M6B	CME
E-MICRO USD/CAD	M6C	CME
E-MICRO USD/CHF	M6S	CME
E-MICRO USD/JPY	M6J	CME
EURO FX	6E	CME
EURO FX (E-MINI)	E7	CME
EURO/AUSTRALIAN $	EAD	CME
EURO/AUSTRALIAN DOLLAR (NEW)	@KRA	ICE
EURO/BRITISH POUND	RP	CME
EURO/BRITISH POUND (NEW)	@KGB	ICE
EURO/CANADIAN $	ECD	CME
EURO/CANADIAN DOLLAR (NEW)	@KEP	ICE
EURO/CZECH KORUNA	@EZ	ICE
EURO/HUNGARIAN FORINT	@HRE	ICE
EURO/JAPANESE YEN	RY	CME
EURO/JAPANESE YEN (NEW)	@KEJ	ICE
EURO/NORWEGIAN KRONE	ENK	CME
EURO/NORWEGIAN KRONE (NEW)	@KOL	ICE
EURO/SO AFR. RAND	@YZ	ICE
EURO/SWEDISH KRONA	ESK	CME
EURO/SWEDISH KRONA (NEW)	@KRK	ICE
EURO/SWISS FRANC	RF	CME
EURO/SWISS FRANC (NEW)	@KRZ	ICE
EURO/US DOLLAR (NEW)	@KEO	ICE
INR/USD E-MICRO	MIR	CME
INR/USD STANDARD	SIR	CME
ISRAELI SHEKEL	ILS	CME
ISRAELI SHEKEL/US DOLLAR	@ILS	ICE
JAPANESE YEN	6J	CME
JAPANESE YEN (E-MINI)	J7	CME
JAPANESE YEN/US $ (NEW)	@KSN	ICE
KOREAN WON/$	KRW	CME
MEXICAN PESO	6M	CME
NEW ZEALAND $	6N	CME
NEW ZEALAND $/YEN	@ZJ	ICE
NORWEGIAN KRONE	NOK	CME
NORWEGIAN KRONE/SWEDISH KRONA	@NJ	ICE
POLISH ZLOTY	PLN	CME
POLISH ZLOTY/EURO	@PLE	ICE
POLISH ZLOTY/EURO	EPZ	CME
RUSSIAN RUBLE	6R	CME
SMALL BRITISH PD/US $	@MP	ICE
SOUTH AFRICAN RAND	6Z	CME
STERLING/AUSTRALIAN $	@QA	ICE
STERLING/CANADIAN $	@PC	ICE
STERLING/NEW ZEALAND $	@GN	ICE
STERLING/NORWAY KRONE	@PK	ICE
SWEDISH KRONA	SEK	CME
SWISS FRANC	6S	CME
SWISS FRANC/JAPANESE YEN	SJY	CME
SWISS FRANC/JAPANESE YEN (NEW)	@KZY	ICE
US $/CZECH KORUNA	@VC	ICE
US $/HUNGARIAN FORINT	@VU	ICE
US $/NORWEGIAN KRONE	@NT	ICE
US $/SOUTH AFRICAN RAND	@ZR	ICE
US $/SWEDISH KRONA	@KXD	ICE
US DOLLAR INDEX	@DX	ICE
USD/OFFSHORE RMB	CNH	CME
Dollar Rates
Contract	Symbol	Exchange
Australian Dollar	AUDUSD	FOREX
British Pound	GBPUSD	FOREX
Canadian Dollar	USDCAD	FOREX
Euro	EURUSD	FOREX
Japanese Yen	USDJPY	FOREX
New Zealand Dollar	NZDUSD	FOREX
Swiss Franc	USDCHF	FOREX
Energy
Contract	Symbol	Exchange
1% FUEL OIL CARGOES FOB NWE CRCK SPRD	QFI	NYMEX
3.5% FUEL OIL BARGES FOB RDAM CRCK (MT)	QBOO	NYMEX
3.5% FUEL OIL BARGES FOB RDAM CRCK SPRD	QFO	NYMEX
ARGUS GASOLINE EUROBOB OXY BGS CRCK SPRD	QEOB	NYMEX
ARGUS LLS VS WTI (ARGUS) TRADE MONTH	QE5	NYMEX
ARGUS PROP FAR E VS EURO PROPANE ARGUS	Q91	NYMEX
ARGUS PROPANE (SAUDI ARAMCO)	Q9N	NYMEX
ARGUS PROPANE FAR EAST INDEX	Q7E	NYMEX
ARGUS PROPANE FAR EAST V JAPAN C&F NAPHT	Q3NA	NYMEX
ARGUS WTI DIFF VS CMA NYMEX TRADE MO	QANT	NYMEX
BRENT CRUDE OIL LAST DAY	QBZ	NYMEX
BRENT DATED FRONTLINE	QFY	NYMEX
BRENT DUBAI	QDB	NYMEX
BRENT FINANCIAL FUTURES	QCY	NYMEX
CHICAGO ETHANOL	QCU	NYMEX
CHICGO ULSD VS NY HARBOR ULSD	Q5C	NYMEX
CLEARBROOK BAKKEN SWEET CRUDE INDEX	QCSW	NYMEX
COAL (API 2) CIF ARA	QMTF	NYMEX
COAL (API 4) FOB RICHARDS BAY	QMFF	NYMEX
CONWAY NATURAL GASOLINE (OPIS)	QA8L	NYMEX
CONWAY NORMAL BUTANE (OPIS)	QA8M	NYMEX
CONWAY PROPANE (OPIS)	QA8K	NYMEX
CRUDE OIL	CL	NYMEX
CRUDE OIL	QCL	NYMEX
CRUDE OIL (E-MINI)	QM	NYMEX
CRUDE OIL BRENT LAST DAY	BZ	NYMEX
CRUDE OIL MICRO	MCL	NYMEX
DUBAI CRUDE OIL CALENDAR	QDC	NYMEX
DUTCH TTF NATURAL GAS	QTTF	NYMEX
EAST WEST NAPHTHA JAPAN CARGOES FOB NWE	QEWN	NYMEX
EAST/WEST GASOLINE SPREAD	QEWG	NYMEX
EIA FLAT TAX ON-HIGHWAY DIESEL	QA5	NYMEX
ETHANOL (PLATTS) T2 FOB RDAM INCL DUTY	QZ1	NYMEX
EURO 3.5% FUEL OIL ROTTERDAM CL	QUV	NYMEX
EURO DIESEL 10 PPM VS LOW SULPHUR GASOIL	QET	NYMEX
EURO FOB RDAM MARINE FUEL 0.5% VS. 3.5%	QR53	NYMEX
EURO NAPHTHA CRACK	QEN	NYMEX
EURO PROPANE CIF ARA	QPS	NYMEX
EURO PROPANE CIF VS. NAPHTHA CIF	QEPN	NYMEX
EUROPEAN 1% FUEL OIL CARGOES FOB NWE	QAUF	NYMEX
EUROPEAN DATED BRENT	QUB	NYMEX
EUROPEAN FOB RDAM MARINE FUEL 0.5% BARGE	QR5F	NYMEX
EUROPEAN LOW SUL GASOIL CRACK SPREAD	QGZ	NYMEX
EUROPEAN LOW SULPHUR GASOIL	QGX	NYMEX
EUROPEAN LOW SULPHUR GASOIL 100MT BULLET	GLI	NYMEX
EUROPEAN LOW SULPHUR GASOIL 100MT BULLET	QGLI	NYMEX
FREIGHT ROUTE LPG BALTIC	QFL	NYMEX
FREIGHT ROUTE TC14 (BALTIC)	QFRC	NYMEX
FREIGHT ROUTE TC2 (BALTIC)	QTM	NYMEX
FREIGHT ROUTE TC5 (PLATTS)	QTH	NYMEX
FREIGHT ROUTE TD20 (BALTIC)	QT2D	NYMEX
FREIGHT ROUTE TD3C (BALTIC)	QTL	NYMEX
GAS EUROBOB OXY NWE BARGES	Q7H	NYMEX
GAS EUROBOB OXY NWE BARGES CRK SPRD	Q7K	NYMEX
GASOIL 0.1 CIF MED VS ICE GASOIL	QZ5	NYMEX
GASOIL 0.1% BARGES FOB ARA	QVL	NYMEX
GC #6 FUEL OIL (PLATTS) CRACK	QMG	NYMEX
GC #6 FUEL OIL 3% (PLATTS) VS BRENT CRCK	QGCI	NYMEX
GC #6 FUEL OIL 3% SULFUR	MFB	NYMEX
GC JET VS HEATING OIL SPREAD	QME	NYMEX
GROUP 3 ULSD (PLATTS) VS NY ULSD	QA6	NYMEX
GRP 3 SUB-OCTANE GAS (PLATTS) VS RBOB	QA8	NYMEX
GUERNSEY LIGHT SWEET CRUDE OIL INDEX	QGSW	NYMEX
GULF COAST CBOB GAS A2 VS RBOB SPREAD	QCBO	NYMEX
GULF COAST ULSD (PLATTS)	QLY	NYMEX
GULF COAST UNL87 M2 (PLATTS) V RBOB SPRD	QRVR	NYMEX
HENRY HUB FINANCIAL	HP	NYMEX
HENRY HUB FINANCIAL	QHP	NYMEX
HENRY HUB FINANCIAL LAST DAY	HH	NYMEX
HENRY HUB FINANCIAL LAST DAY	QHH	NYMEX
HENRY HUB NATURAL GAS FINCL	QNN	NYMEX
HENRY HUB NATURAL GAS PENULTIMATE	QNP	NYMEX
ISO NEW ENGLAND INTERNAL HUB 5 MW PEAK	QAU6	NYMEX
JAPAN C&F NAPHTHA	QJA	NYMEX
JAPAN C&F NAPHTHA CRACK SPREAD	QJB	NYMEX
JAPAN CRUDE COCKTAIL (DETAILED)	QJCC	NYMEX
JET CARGOES CIF NWE VS LOW SUL GASOIL	QJC	NYMEX
LA CARB DIESEL VS NY ULSD	QKL	NYMEX
LA JET OPIS VS NY ULSD	QJS	NYMEX
LIGHT SWEET OIL (NET ENERGY) INDEX	QLSW	NYMEX
LLS (ARGUS) V WTI	QWJ	NYMEX
LNG FREIGHT ROUTE BLNG2G (BALTIC)	QBL2	NYMEX
LNG JAPAN/KOREA MARKER (PLATTS)	QJKM	NYMEX
LOW SULPHUR GASOIL (10MT) FINANCIAL	QMQA	NYMEX
LOW SULPHUR GASOIL MINI FINANCIAL	QQA	NYMEX
MARS (ARGUS) V WTI	QYX	NYMEX
MARS (ARGUS) V WTI TRADE MONTH	QYV	NYMEX
METHANOL CFR CHINA SPECIFIC ORIGIN ICIS	QCMS	NYMEX
METHANOL T2 FOB RDAM (ICIS)	QMT2	NYMEX
MICRO EUROPEAN 3.5% FUEL OIL BARGES RDAM	QMEF	NYMEX
MICRO EUROPEAN FOB RDAM MARINE FUEL 0.5%	QR5O	NYMEX
MICRO GASOIL 0.1% BARGES FOB ARA PLATTS	QM1B	NYMEX
MICRO NEW YORK HARBOR ULSD	QMHO	NYMEX
MICRO RBOB GASOLINE	QMRB	NYMEX
MICRO SINGAPORE FOB MARINE FUEL 0.5%	QS5O	NYMEX
MICRO SINGAPORE FUEL OIL 380CST (PLATTS)	QMAF	NYMEX
MICRO WTI CRUDE OIL	QMCL	NYMEX
MINI ARGUS PROPANE ARAMCO	QMAS	NYMEX
MINI ARGUS PROPANE FAR EAST	QMAE	NYMEX
MINI BRENT FINANCIAL FUTURES	QMBC	NYMEX
MINI EUR 1 % FUEL OIL NWE	Q0B	NYMEX
MINI EUR 3.5% FUEL OIL RDAM	Q0D	NYMEX
MINI EURO PROPANE CIF ARA	QMPS	NYMEX
MINI EUROPEAN FOB RDAM MARINE FUEL 0.5%	QR5M	NYMEX
MINI EUROPEAN NAPHTHA CIF NWE	QMNC	NYMEX
MINI GASOLINE EUROBOB OXY NWE BARGES	QMEO	NYMEX
MINI JAPAN C&F NAPHTHA	QMJN	NYMEX
MINI RBOB VS GAS EURO-BOB OXY NWE	QMXB	NYMEX
MINI SINGAPORE FOB MARINE FUEL 0.5%	QS5M	NYMEX
MINI SINGAPORE FUEL OIL 380	QMTS	NYMEX
MONT BELVIEU ETHANE	QAC0	NYMEX
MONT BELVIEU ETHYLENE (PCW) FIN	QMBN	NYMEX
MONT BELVIEU ISO BUTANE 5 DECIMAL	Q8I	NYMEX
MONT BELVIEU LDH ISOBUTANE OPIS	QMBL	NYMEX
MONT BELVIEU LDH PROPANE	QB0	NYMEX
MONT BELVIEU LDH PROPANE VS. ARGUS	QPMF	NYMEX
MONT BELVIEU LDH VS EURO PROPANE CIF	Q51	NYMEX
MONT BELVIEU NATURAL GASOLINE	Q7Q	NYMEX
MONT BELVIEU NATURAL GASOLINE SWAP	A7Q	NYMEX
MONT BELVIEU NORMAL BUTANE NON-LDH	QAD0	NYMEX
MONT BELVIEU SPOT ETHYLENE (PCW) IN WELL	QMBE	NYMEX
NAPHTHA CARGOES CIF NWE (PLATTS)	QUN	NYMEX
NAPHTHA CARGOES CIF NWE CRK SPRD 1000MT	QNOB	NYMEX
NATURAL GAS	NG	NYMEX
NATURAL GAS	QNG	NYMEX
NATURAL GAS (E-MINI)	QG	NYMEX
NEPOOL INTERNAL HUB 5 MW DAY AHEAD(O/P)	QH2L	NYMEX
NEW YORK ETHANOL	QEZ	NYMEX
NEW YORK HARBOR ULSD	HO	NYMEX
NEW YORK HARBOR ULSD	QHO	NYMEX
NY BUCKEYE JET FUEL VS NY ULSD	QJET	NYMEX
NY HARBOR RESIDUAL FUEL 1.0%S	QMM	NYMEX
NY HARBOR ULSD BRENT CRACK SPREAD	QHOB	NYMEX
NY HARBOR ULSD BULLET	QBH	NYMEX
NY HARBOR ULSD CRACK SPREAD	QHK	NYMEX
NY HARBOR ULSD FINANCIAL	QMPX	NYMEX
NY HARBOR ULSD VS GASOIL 1000BBL	QNLS	NYMEX
NY ULSD ARGUS VS NY HARBOR ULSD SPREAD	Q7Y	NYMEX
NYH ULSD (E-MINI)	QH	NYMEX
NYISO ZN G 5 MW DAY AHEAD (PEAK)	QT3	NYMEX
PGP POLYMER GRADE PROPYLENE SWAPS	QPGP	NYMEX
PJM AD HUB 5 MW RT (OFF PEAK)	QV3	NYMEX
PJM AD HUB 5 MW RT (PEAK)	QAZ9	NYMEX
PJM WEST OFF_PEAK RT LMP	QN9	NYMEX
PJM WESTERN HUB PEAK CAL-MO RT LMP	QAL1	NYMEX
PREM UNL 10 PPM (PLATTS) FOB MED	Q3G	NYMEX
PROPANE NON-LDH MT BELVIEU OPIS	Q1R	NYMEX
RBOB CALENDAR	QRLX	NYMEX
RBOB CRACK SPREAD	QARE	NYMEX
RBOB FINANCIAL	QRT	NYMEX
RBOB GASOLINE	QRB	NYMEX
RBOB GASOLINE	RB	NYMEX
RBOB GASOLINE (E-MINI)	QU	NYMEX
RBOB GASOLINE VS BRENT CRACK SPREAD	QRBB	NYMEX
RBOB GASOLINE VS EUROBOB OXY NWE	QEXR	NYMEX
RBOB VS NY HARBOR ULSD	QRH	NYMEX
SINGAPORE 380CST FUEL OIL	QSE	NYMEX
SINGAPORE FOB MARINE FUEL 0.5% (PLATTS)	QS5F	NYMEX
SINGAPORE FOB MARINE FUEL 0.5% V 380 CST	QS53	NYMEX
SINGAPORE FUEL OIL SPREAD	QSD	NYMEX
SINGAPORE GAS OIL	QSG	NYMEX
SINGAPORE GASOIL VS LOW SULPHUR	QGA	NYMEX
SINGAPORE MOGAS 92 UNL BRENT CRACK	Q1NB	NYMEX
UP DOWN GC ULSD VS NYMEX HO SPREAD	QLT	NYMEX
USGC MARINE FUEL 0.5% BARGES (PLATTS)	QH5F	NYMEX
WESTERN CANADIAN SELECT OIL INDEX	QWCW	NYMEX
WTI BRENT CALENDAR	QBK	NYMEX
WTI FINANCIAL FUTURES	QCSX	NYMEX
WTI HOUSTON VS WTI FINANCIAL	QHIL	NYMEX
WTI HOUSTON VS WTI TRADE MONTH	QHTT	NYMEX
WTI MIDLAND (ARGUS) VS WTI FINCL	QFF	NYMEX
WTI MIDLAND VS WTI TRADE MONTH	QWTT	NYMEX
WTS (ARGUS) V WTI TRADE MONTH	QFH	NYMEX
Euro Rates
Contract	Symbol	Exchange
Australian Dollar	EURAUD	FOREX
British Pound	EURGBP	FOREX
Canadian Dollar	EURCAD	FOREX
Danish Krone	EURDKK	FOREX
Japanese Yen	EURJPY	FOREX
Norwegian Krone	EURNOK	FOREX
Swedish Krona	EURSEK	FOREX
Swiss Franc	EURCHF	FOREX
Food and Fiber
Contract	Symbol	Exchange
BUTTER-CASH SETTLED	CB	CME
CHEESE-CASH SETTLED	CSC	CME
COCOA	@CC	ICE
COFFEE	@KC	ICE
COTTON #2	@CT	ICE
DRY WHEY	DY	CME
LUMBER (RANDOM LENGTH)	LBS	CME
MILK CLASS III	DC	CME
MILK CLASS IV	GDK	CME
NONFAT DRY MILK	GNF	CME
ORANGE JUICE - A	@OJ	ICE
SUGAR #11 WORLD	@SB	ICE
SUGAR #16	@SFI	ICE
Grains and Oilseeds
Contract	Symbol	Exchange
CORN	ZC	CBOT
CORN (MINI)	XC	CBOT
HARD RED SPRING WHEAT	@MW	MGEX
HARD RED WINTER WHEAT	@KW	KCBT
OATS	ZO	CBOT
ROUGH RICE	ZR	CBOT
SOYBEAN (MINI)	XK	CBOT
SOYBEAN MEAL	ZM	CBOT
SOYBEAN OIL	ZL	CBOT
SOYBEANS	ZS	CBOT
WHEAT	ZW	CBOT
WHEAT (MINI)	XW	CBOT
Indexes
Contract	Symbol	Exchange
BLOOMBERG COMMODITY INDEX	AW	CBOT
DJ $5 (E-MINI)	YM	CBOT
FTSE 50 CHINA INDEX (E-MINI)	FT5	CME
MICRO E-MINI NASDAQ-100 INDEX	MNQ	CME
MICRO E-MINI RUSSELL 2000 INDEX	M2K	CME
MICRO E-MINI S&P 500 INDEX	MES	CME
MINI MSCI ACWI NTR INDEX	@MMW	ICE
MINI MSCI EAFE INDEX	@MFS	ICE
MINI MSCI EM ASIA NTR INDEX	@ASN	ICE
MINI MSCI EMERGING MARKETS	@MME	ICE
MINI MSCI EMERGING MKTS NTR INDEX	@MMN	ICE
MINI MSCI WORLD INDEX	@MWL	ICE
MSCI EMER MKT EMEA NTR INDEX	@MMM	ICE
MSCI EMER MKT LAT AM NTR INDEX	@MML	ICE
MSCI EUROPE NTR INDEX	@EU9	ICE
MSCI INDIA NTR INDEX	@MIN	ICE
MSCI JAPAN NTR INDEX	@JPP	ICE
MSCI PACIFIC NTR INDEX	@MPA	ICE
MSCI USA GTR INDEX	@USS	ICE
MSCI WORLD NTR INDEX	@MWS	ICE
NASDAQ 100 INDEX (E-MINI)	NQ	CME
NASDAQ BIOTECH (E-MINI)	BIO	CME
NIKKEI 225 INDEX $ INDEX	NKD	CME
NIKKEI 225 INDEX YEN INDEX	NIY	CME
RUSSELL 1000 GROWTH INDEX (E-MINI)	RSG	CME
RUSSELL 1000 INDEX (E-MINI)	RS1	CME
RUSSELL 1000 VALUE INDEX (E-MINI)	RSV	CME
RUSSELL 2000 (E-MINI)	RTY	CME
S&P 500 INDEX (E-MINI)	ES	CME
S&P 500 INDEX ANNUAL DIVIDEND INDEX	SDA	CME
S&P 500 INDEX CONSUMER DISCRETIONARY (E-MINI)	XAY	CME
S&P 500 INDEX CONSUMER STAPLES (E-MINI)	XAP	CME
S&P 500 INDEX DIVIDEND INDEX (QUARTERLY)	SDI	CME
S&P 500 INDEX ENERGY SECTOR (E-MINI)	XAE	CME
S&P 500 INDEX FINANCIAL SECTOR (E-MINI)	XAF	CME
S&P 500 INDEX HEALTHCARE SECTOR (E-MINI)	XAV	CME
S&P 500 INDEX INDUSTRIAL SECTOR (E-MINI)	XAI	CME
S&P 500 INDEX MATERIALS SECTOR (E-MINI)	XAB	CME
S&P 500 INDEX TECHNOLOGY SECTOR (E-MINI)	XAK	CME
S&P 500 INDEX UTILITIES SECTOR (E-MINI)	XAU	CME
S&P GSCI	GD	CME
S&P MIDCAP 400 INDEX (E-MINI)	EMD	CME
Interest Rates
Contract	Symbol	Exchange
10 YEAR T-NOTES	ZN	CBOT
10 YEAR USD INT RATE SWAP	N1U	CBOT
2 YEAR T-NOTES	ZT	CBOT
3 YEAR T-NOTES	Z3N	CBOT
30 DAY FED FUND	ZQ	CBOT
5 YEAR T-NOTES	ZF	CBOT
5 YEAR USD INT RATE SWAP	F1U	CBOT
EURODOLLAR	GE	CME
T-BONDS	ZB	CBOT
ULTRA 10 YEAR T-NOTES	TN	CBOT
ULTRA T-BONDS	UB	CBOT
Livestock and Meats
Contract	Symbol	Exchange
FEEDER CATTLE	GF	CME
LEAN HOGS	HE	CME
LIVE CATTLE	LE	CME
Metals
Contract	Symbol	Exchange
1000 OZ MINI SILVER	@YI	ICE
ALUMINUM	ALI	NYMEX
COPPER	HG	NYMEX
COPPER (E-MINI)	QC	NYMEX
DOMESTIC HOT-ROLLED COIL STEEL	HRC	NYMEX
E-MICRO GOLD	MGC	NYMEX
GOLD	GC	NYMEX
GOLD (E-MINI)	QO	NYMEX
Gold Spot	XAUUSDO	FOREX
PALLADIUM	PA	NYMEX
PALLADIUM	QPA	NYMEX
Palladium Spot	XPDUSDO	FOREX
PLATINUM	PL	NYMEX
PLATINUM	QPL	NYMEX
Platinum Spot	XPTUSDO	FOREX
PLATTS ALUMINUM US TRANSACTION PREM	AUP	NYMEX
SILVER	SI	NYMEX
SILVER (E-MINI)	QI	NYMEX
SILVER 1000 OZ	SIL	NYMEX
Silver Spot	XAGUSDO	FOREX
US MIDWEST #1 BUSHELING FERROUS SCRAP	BUS	NYMEX
Real Estate
Contract	Symbol	Exchange
DJ US REAL ESTATE INDEX	RX	CBOT
S&P REAL ESTATE SECTOR (E-MINI)	XAR	CME
Weather
Contract	Symbol	Exchange
EDMONTON C5+ CONDENSATE INDEX	QCC5	NYMEX
        }

Other Asian Currencies
Contract	Symbol	Exchange
Hong Kong Dollar	USDHKD	FOREX
Indian Rupee	USDINR	FOREX
Indonesian Rupiah	USDIDR	FOREX
Malaysian Ringt	USDMYR	FOREX
Philippine Peso	USDPHP	FOREX
Singapore Dollar	USDSGD	FOREX
South Korean Won	USDKRW	FOREX
Thai Baht	USDTHB	FOREX
Other European Currencies
Contract	Symbol	Exchange
Czech Koruna	USDCZK	FOREX
Danish Krone	USDDKK	FOREX
Hungarian Forint	USDHUF	FOREX
Norwegian Krone	USDNOK	FOREX
Polish New Zloty	USDPLN	FOREX
Russian Ruble	USDRUB	FOREX
Swedish Krona	USDSEK	FOREX
Other World Currencies
Contract	Symbol	Exchange
Brazilian Real	USDBRL	FOREX
Egyptian Pound	USDEGP	FOREX
Israeli Shekel	USDILS	FOREX
Mexican Peso	USDMXN	FOREX
South African Rand	USDZAR	FOREX
Tunisian Dinar	USDTND	FOREX
